11111111111111111111111111111111111111111111111111
1P0000000000000000000000000000000000000000000000C1
10101010101010101010101010101010101010101010101001
10000000000000000000000000000000000000000000000001
10101010101010101010101010101010101010101010101001
100000000000000000000000000000000000000000000000C1
10101010101010101010101010101010101010101010101001
10000000000000000000000000000000000000000000000001
10101010101010101010101010101010101010101010101001
1C0000000000000000000000000000000000000000000000E1
11111111111111111111111111111111111111111111111111
