1111
1P01
1#01
1C01
1#01
1E01
1111
