1111111111111111111111111111111111111111111111111
1P0000101C000000000001C00000001100C11000000000001
1011101110111011110111110111011110111C11101111101
1000100C100010001000000000C100000000C10000001C001
1110111011101110111011101110111011101110111011111
1C000010101000001C00101000001C00000010000000000C1
1111111011111011111011111011111011111011111011101
10000010000C100000000001C010000000000000000010101
1011101110111011110111011111111011101110111011101
100C1000000000100000C1000C101C0010100000C000000E1
1111111111111111111111111111111111111111111111111
