11111111111111111111111111111111111111111111111111
1P00000000C000000000000000000000000000000000000001
10111110111110111110111110111110111110111110111001
10000000000000000000000000000000000000000000000001
10111011111011111011111011111011111011111011111001
1C0000000000000000000000000000000000000000000000C1
10111110111110111110111110111110111110111110111001
10000000000000000000000000000000000000000000000001
10111011111011111011111011111011111011111011111001
1C0000000000000000000000000000000000000000000000E1
11111111111111111111111111111111111111111111111111
