1111111111111
100100000000*
100001111100*
1P0011E0000C*
1111111111111
