1111111111111
1001C000000C1
1000011101101
100011E1000C1
1P00110001111
1111111111111
