11111
10P01
10#01
10CC1
10#C1
10E#1
11111
