1111111111111
10010000000C1
10000111100#1
1P00110000#E1
1111111111111
