1111111111111
1#01C000000C1
100001110#101
100011E1000C1
1P00110001111
100001C10#101
100001C10#101
100001C10#101
100001C10#101
100001C10#101
100001C10#101
100001C10#101
100001C10#101
100001C10#101
100001C10#101
100001C10#101
100001C10#101
100001C10#101
100001C10#101
100001C10#101
100001C10#101
100001C10#101
100001C10#101
100001C10#101
100001C10#101
100001C10#101
100001C10#101
100001C10#101
100001C10#101
100001C10#101
100001C10#101
100001C10#101
100001C10#101
100001C10#101
100001C10#101
100001C10#101
100001C10#101
100001C10#101
100001C10#101
100001C10#101
100001C10#101
100001C10#101
100001C10#101
100001C10#101
100001C10#101
100001C10#101
100001C10#101
100001C10#101
100001C10#101
100001110#101
100001110#101
100001110#101
100001110#101
100001110#101
100001110#101
100001110#101
100001110#101
100001110#101
100001110#101
100001110#101
100001110#101
1111111111111
