111111111111111111111111111111
1P00001#0C00000C#1000000000001
101110111011100111C1110#111101
1000100C100010000C#1000001C001
1#1011101110#11101110111011111
1C000#100#10000001#000000000C1
11111110111110111110111101C101
10000010000C10000000000001#101
10#110111011101101#101#1011101
100C1000000000C100000C000000E1
111111111111111111111111111111
